mighty-spanner=ui_mechanical_1
eye-target=ui_mechanical_2
big-gear=ui_mechanical_3
cog-lock=ui_mechanical_4
artificial-intelligence=ui_mechanical_5
trefoil-shuriken=ui_domination_1
sword-clash=ui_domination_6
eagle-emblem=ui_domination_7
steelwing-emblem=ui_domination_8
virtual-marker=ui_blocky_1
triple-beak=ui_ornate_1
triple-corn=ui_ornate_2
triple_plier=ui_ornate_3
triple_yin=ui_ornate_4
north-star-shuriken=ui_pointy_2
digital-trace=ui_spherical_digital-trace
orb-direction=ui_spherical_orb-direction
targeted=ui_spherical_targeted
communism_bulgaria=ui_human_communist_bulgarian
altarian=flag_ui_galciv_altarian
drengin=flag_ui_galciv_drengin
terran=flag_ui_galciv_terran
torian=flag_ui_galciv_torian
yor=flag_ui_galciv_yor
protoss=flag_ui_starcraft_protoss
umoja=flag_ui_starcraft_umoja
zerg=flag_ui_starcraft_zerg
ued=flag_ui_starcraft_ued
raynor=flag_ui_starcraft_raynor
kelmoria=flag_ui_starcraft_kelmoria
korhal=flag_ui_starcraft_korhal
dominion=flag_ui_terran_dominion
confederation=flag_ui_terran_confederation
akilae=flag_ui_terran_akilae
galactic-empire=flag_ui_starwars_empire
rebel-alliance=flag_ui_starwars_rebels
microscope-lens=ui_mechanical_microscope-lens
pokecog=ui_mechanical_pokecog